111111111111
1P00000000E1
1WWWW00WWWW1
1XXXX00XXXX1
1C0000000001
100000000001
10000000C001
1WWWW00WWWW1
1XXXX00XXXX1
1C0000000001
111111111111