111111111111
1P0CCCCCCCE1
1WWWWCCWWWW1
1XXXXCCXXXX1
1CCCCCCCCCC1
1CCCCCCCCCC1
1CCCCCCCCCC1
1WWWWCCWWWW1
1XXXXCCXXXX1
1CCCCCCCCCC1
111111111111