1111111111111
1CCCCCCCCCC11
1WWWWCCWWWW11
1XXXXCCXXXX11
1CCCCCCCCCC11
1WWWWCCWWWW11
1XXXXCCXXXX11
1CCCCCCCCCC11
1WWWWCCCC0P11
1XXXXCCCCC0E1
1CCCCCCCCCC11
1WWWWCCWWWW11
1XXXXCCXXXX11
1CCCCCCCCCC11
1WWWWCCWWWW11
1XXXXCCXXXX11
1CCCCCCCCCCC1
1CCZCCZCCZCC1
1CCYCCYCCYCC1
1CCZCCZCCZCC1
1CCYCCYCCYCC1
1CCZCCZCCZCC1
1CCYCCYCCYCC1
1111111111111