1111111111111
1P00W000000E1
10000C0000001
1111111111111