111111111111
1P0000000VE1
1WWWW00WWWW1
1XXXX00XXXX1
100000000001
100000000001
1WWWW00WWWW1
1XXXX00XXXX1
10000C000001
111111111111