1111111111111
1P00000000VE1
1WWWW000WWWW1
1XXXX000XXXX1
1000000000001
1000000000001
1WWWW000WWWW1
1XXXX000XXXX1
10000C0000001
1111111111111