1111111111111
1P000000000E1
1W000C0000001
10000C0000001
10000C0000001
10000C0000001
1111111111111