11111111111111111111111111111
10Z0ZCZ0Z0Z0Z0ZCZ0Z0Z0Z0Z0Z01
10Y0Y0Y0Y0Y0Y0Y0Y0Y0Y0Y0YCY01
10ZCZ0Z0Z0ZCZ0Z0ZCZ0Z0Z0Z0Z01
10Y0Y0Y0Y0Y0YCY0Y0Y0Y0Y0Y0Y01
1CZ0Z0Z0Z0Z0Z0Z0Z0ZCZ0Z0Z0Z01
10Y0Y0YCYCY0Y0Y0Y0Y0Y0Y0Y0YC1
10000000000000000000000000001
10000000000000000000000000001
1XWXWXW00XXXXXXXXX10011111111
10000C00000C00000010011111111
1XWXWXW00WXWXWXWXW10011111111
10000000V0000000C010011111111
1XWXWXW00WXWXWXWXW10011111111
100000C0000000000010011111111
1XWXWXW00WXWXWXWXW10011111111
1000C00000C00000001000E111111
1XWXWXW00WXWXWXWXW10001111111
10000000000000000C10011111111
1XWXWXW00WXWXWXWXW10011111111
1000C000000000000010011111111
1XWXWXW00WXWXWXWXW10011111111
10000000000000C00010011111111
100000000WXWXWXWXW10011111111
10000000000C00000010011111111
100000000WXWXWXWXW10011111111
10000P00000000000000011111111
11111111111111111111111111111