1111111111111
1000000000VE1
1WWWW00WWWW11
1XXXX00XXXX11
1000000000011
1000000000011
1WWWW00WWWW11
1XXXX00XXXX11
10000C0000011
1111100111111
1C00000000C11
1WWWW00WWWW11
1XXXX00XXXX11
1000C00C00011
1WWWW00WWWW11
1XXXX00XXXX11
1C00000000011
1WWWW00000001
1XXXX000000P1
1C00000000011
1WWWW00WWWW11
1XXXX00XXXX11
1000C00000011
1WWWW00WWWW11
1XXXX00XXXX11
10000000000C1
100Z00Z00Z001
100Y00Y00Y001
100Z00Z00Z001
100Y00Y0CY001
100Z00Z00Z001
1C0Y00Y00Y001
1111111111111