111111111
1000ZEV01
1CWXYZZC1
10000Z001
1P00C0001
111111111