111111111111
100000000CP1
1WWWW00WWWW1
1XXXX00XXXX1
100000000001
100000000001
1WWWW00WWWW1
1XXXX00XXXX1
1VE000000001
111111111111